AAAAAAA	Tau Bananaramus XI						
AAAAAAB	Psi Clinton IV						
AAAAAAC	Sigma Diverticulus XI						
AAAAAAD	Chi Perambulus XI						
AAAAAAE	Rho Clinton V						
AAAAAAF	Theta Dyxichix IV						
AAAAAAG	Yodeli Taylor VI						
AAAAAAH	Eta Molotov VI						
AAAAAAI	Lambda Waldorf VII						
AAAAAAJ	Waldorfus Zevon II						
AAAAAAK	Corpulus Nicholson VIII						
AAAAAAL	Epsilon Blivebarkerus VII						
AAAAAAM	Bananaramus Noriega III						
AAAAAAN	Bubblicius Smith IV						
AAAAAAO	Upsilon Martinez IV						
AAAAAAP	Omicron Perfunctus XI						
AAAAAAQ	Gamma Corpulus X						
AAAAAAR	Mu Mack X						
AAAAAAS	Nu Mexicanus XI						
AAAAAAT	Zeta Hall II						
AAAAAAU	Iota Hamburguesus V						
AAAAAAV	Upsilon O'Kelly IV						
AAAAAAW	Polepositioni McDonald XI						
AAAAAAX	Fustulus Harris V						
AAAAAAY	Sigma Draper VIII						
AAAAAAZ	Omicron Peterson VIII						
AAAAABA	Corpulus King X						
AAAAABB	Lambda Clinton VIII						
AAAAABC	Dyxichix Jones IV						
AAAAABE	Eta Moore XI						
AAAAABF	Diggusduggus Madison I						
AAAAABG	Omega Discothecus II						
AAAAABH	Eta McMahon V						
AAAAABI	Perambulus Salisbury VI						
AAAAABK	Omega McMahon III						
AAAAABL	Tau Harris III						
AAAAABM	Chi Cattusdoggus VIII						
AAAAABN	Sigma Cooper IV						
AAAAABO	Epsilon Buck V						
AAAAABP	Kappa Abbrevianus III						
AAAAABQ	Beta Rutgers X						
AAAAABR	Nu Smith IV						
AAAAABS	Billclintonus Wallace III						
AAAAABT	Phi Rutgers IV						
AAAAABU	Xi Nite X						
AAAAABV	Rho Belvedere IX						
AAAAABW	Gamma Belletaco VI						
AAAAABX	Fustulus Belvedere IV						
AAAAABY	Zeta Dunn I						
AAAAABZ	Corpulus Pennington X						
AAAAACA	Epsilon Jones VI						
AAAAACB	Beta Waldorfus VIII						
AAAAACC	Chi Durden V						
AAAABAA	Eta Paulreichus IV						
AAAABAB	Epsilon Jones VI						
AAAABAC	Beta Waldorfus VIII						
AAAABBA	Dyxichix Meadows III						
AAAABBB	Discothecus Lennon II						
AAAABBC	Beta Jones XI						
AAAABCA	Paulreichus Haggard VII						
AAAABCB	Eta Milkius I						
AAAABCC	Psi Bearthurus I						
AAAACAA	Gamma Yodeli V						
AAAACAB	Paulreichus Haggard VII						
AAAACAC	Eta Milkius I						
AAAACAD	Psi Bearthurus I						
AAAACBA	Mu Nelson X						
AAAACBB	Tau Allen V						
AAAACBC	Chi Cattusdoggus IX						
AAAACCA	Delta King IV						
AAAACCB	Corpulus Reagan X						
AAAACCC	Upsilon Johnson XI						
AAABAAA	Rho Cheetus II						
AAABAAB	Dyxichix Meadows III						
AAABAAC	Discothecus Lennon II						
AAABABA	Gamma Yodeli V						
AAABABB	Paulreichus Haggard VII						
AAABABC	Eta Milkius I						
AAABACA	Mu Nelson X						
AAABACB	Tau Allen V						
AAABACC	Chi Cattusdoggus IX						
AAABBAA	Eta Diverticulus III						
AAABBAB	Mu Nelson X						
AAABBAC	Tau Allen V						
AAABBBA	Discothecus Clark VII						
AAABBBB	Delta King IV						
AAABBBC	Corpulus Reagan X						
AAABBBD	Upsilon Johnson XI						
AAABBBE	Mu Fredfordus IX						
AAABBBF	Discothecus Smith X						
AAABBBG	Eta Haggard XI						
AAABBBH	Cardboardius Hall II						
AAABBBI	Phi Cartwright III						
AAABBBJ	Pi Romero VIII						
AAABBCA	Gamma Clinton III						
AAABBCB	Xi Meadows VI						
AAABBCC	Omega Bob II						
AAABCAA	Delta Humptydumptus XI						
AAABCAB	Gamma Clinton III						
AAABCAC	Xi Meadows VI						
AAABCBA	Perfunctus Smith III						
AAABCBB	Mu Steadwick IX						
AAABCBC	Omega Bob III						
AAABCCA	Omega Pannus VI						
AAABCCB	Beta Hernandez II						
AAABCCC	Mu Durden VIII						
AAACAAA	Iota Moore IX						
AAACAAB	Discothecus Clark VII						
AAACAAC	Delta King IV						
AAACABA	Delta Humptydumptus XI						
AAACABB	Gamma Clinton III						
AAACABC	Xi Meadows VI						
AAACACA	Perfunctus Smith III						
AAACACB	Mu Steadwick IX						
AAACACC	Omega Bob III						
AAACBAA	Tau Allopecius X						
AAACBAB	Perfunctus Smith III						
AAACBAC	Mu Steadwick IX						
AAACBBA	Epsilon Paulreiserus I						
AAACBBB	Omega Pannus VI						
AAACBBC	Beta Hernandez II						
AAACBCA	Upsilon Disraeli IV						
AAACBCB	Xi Berry XI						
AAACBCC	Tau Gronulus XI						
AAACCAA	Yodeli Thompson V						
AAACCAB	Upsilon Disraeli IV						
AAACCAC	Xi Berry XI						
AAACCBA	Rho Moore V						
AAACCBB	Pi Jones III						
AAACCBC	Xi Pacmanicus XI						
AAACCCA	Phi Crustulus VII						
AAACCCB	Epsilon Jones VIII						
AAACCCC	Chi Taylor IX						
AAACIJD	Zeta Nelson XI						
AAAOFWA	Mu Linoleus III						
AAARRGG	Psi Fritus II						
AAAZAAA	Omicron Paulreiserus IV						
AABAAAA	Zeta Belvedere IV						
AABAAAB	Gamma Yodeli V						
AABAAAC	Paulreichus Haggard VII						
AABAABA	Eta Diverticulus III						
AABAABB	Mu Nelson X						
AABAABC	Tau Allen V						
AABAACA	Discothecus Clark VII						
AABAACB	Delta King IV						
AABAACC	Corpulus Reagan X						
AABABAA	Iota Moore IX						
AABABAB	Discothecus Clark VII						
AABABAC	Delta King IV						
AABABBA	Delta Humptydumptus XI						
AABABBB	Gamma Clinton III						
AABABBC	Xi Meadows VI						
AABABCA	Perfunctus Smith III						
AABABCB	Mu Steadwick IX						
AABABCC	Omega Bob III						
AABACAA	Tau Allopecius X						
AABACAB	Perfunctus Smith III						
AABACAC	Mu Steadwick IX						
AABACBA	Epsilon Paulreiserus I						
AABACBB	Omega Pannus VI						
AABACBC	Beta Hernandez II						
AABACCA	Upsilon Disraeli IV						
AABACCB	Xi Berry XI						
AABACCC	Tau Gronulus XI						
AABBAAA	Tau Clark II						
AABBAAB	Delta Humptydumptus XI						
AABBAAC	Gamma Clinton III						
AABBABA	Tau Allopecius X						
AABBABB	Perfunctus Smith III						
AABBABC	Mu Steadwick IX						
AABBACA	Epsilon Paulreiserus I						
AABBACB	Omega Pannus VI						
AABBACC	Beta Hernandez II						
AABBBAA	Upsilon Peterson VI						
AABBBAB	Epsilon Paulreiserus I						
AABBBAC	Omega Pannus VI						
AABBBBA	Yodeli Thompson V						
AABBBBB	Upsilon Disraeli IV						
AABBBBC	Xi Berry XI						
AABBBCA	Rho Moore V						
AABBBCB	Pi Jones III						
AABBBCC	Xi Pacmanicus XI						
AABBCAA	Gamma Benedict III						
AABBCAB	Rho Moore V						
AABBCAC	Pi Jones III						
AABBCBA	Xi Goldthwait I						
AABBCBB	Phi Crustulus VII						
AABBCBC	Epsilon Jones VIII						
AABBCCA	Bellegrandus Haskell X						
AABBCCB	Rho Simon II						
AABBCCC	Dickbutkus King IV						
AABCAAA	Beta Reagan XI						
AABCAAB	Yodeli Thompson V						
AABCAAC	Upsilon Disraeli IV						
AABCABA	Gamma Benedict III						
AABCABB	Rho Moore V						
AADLMZE	Dickbutkus Harris III						
AALAAAD	Omicron Linoleus VI						
AALOAAJ	Phi Pacmanicus VII						
AARRGHH	Eta Pacmanicus XI						
AARRRGH	Eta Zevon II						
AASRPEM	Chi Black XI						
ABAAAAA	Pi Belletaco XI						
ABAAAAB	Eta Diverticulus III						
ABABYBE	Xi Easthouse VI						
ABACABA	Cheetus McDurkee I						
ABACADA	Psi Clinton IX						
ABACTOR	Alpha Mack VII						
ABALONE	Beta Bubblewrapium VI						
ABANDED	Theta Polepositioni VIII						
ABANDON	Molotov Stemple IX						
ABASERS	Rho Black V						
ABASHED	Fritus Woodward I						
ABASHES	Unicornius Thompson VII						
ABASIAS	Microscopius O'Reilly V						
ABASING	Nu Black IX						
ABATERS	Pi Dudebaddus V						
ABATING	Lambda Goldthwait VII						
ABBAAAA	Xi Fredfordus XI						
ABBABBA	Cheetus McDurkee I						
ABBAFAN	Rho Shatner XI						
ABCABCA	Tau Adams VIII						
ABCBCBA	Sigma Cartwright I						
ABCDCBA	Theta Steadwick VIII						
ABCDEFG	Omega Allen IX						
ABDAAAA	Chi Thompson I						
ABIGTIT	Lambda Fustulus I						
ABSCOND	Iota Belletaco XI						
ACAAAAA	Sigma Reynolds IV						
ACAKAIM	Blivebarkerus Paulson V						
ACBCDCE	Psi Mills VIII						
ACETONE	Omega O'Reilly VI						
ACRIMBO	Zeta Perambulus X						
ADCBACA	Tau Zevon VIII						
ADGJLMB	Theta Equipajus VII						
ADKXBVY	Corpulus Des Moines VIII						
ADOREME	Xi Microscopius V						
ADORESU	Chi Corpulus IV						
ADRAGON	Gamma Hippidipsus VI						
AELEVEN	Gamma Anderson X						
AENIMUS	Omicron Allopecius VII						
AEROGEL	Pacmanicus Garcia III						
AFAIRYS	Chi Paulreichus I						
AGWCPRE	Mu Davis XI						
AHHHHHH	Kappa Tyler IV						
AHRPSTA	Tau Wilson V						
AINCCLQ	Phi Williams VIII						
AIRSHIP	Zeta Cromulus III						
AJAAAAA	Pi Jackson I						
AKAAAAA	Xi Des Moines VIII						
ALABAST	Microscopius Garcia XI						
ALABITE	Omicron Dominatrix II						
ALACEHO	Alpha Trixrabbitus VIII						
ALADDIN	Epsilon Humptydumptus VIII						
ALAMIDA	Lambda Humptydumptus V						
ALCOHOL	Eta Humptydumptus II						
ALIBABA	Zeta Taylor VIII						
ALLADIN	Alpha King X						
ALLEGRO	Omicron O'Kelly IX						
ALLONSY	Eta Dudebaddus III						
ALPHAAZ	Beta Goodman XI						
ALTRINA	Cancerus Garfield I						
ALTRNIA	Zeta McDurkee III						
ALVINNN	Nu Haskell IV						
AMAZONA	Gamma Disraeli IV						
AMERICA	Theta Stemple V						
AMFKCUD	Theta Benedict III						
AMOLLYA	Epsilon North XI						
ANALPAL	Upsilon Milkius XI						
ANALSEX	Slobulus Wilson VI						
ANANGEL	Iota Conjunctivitus II						
ANATOLE	Bob O'Reilly II						
ANCIENT	Iota Smith II						
ANDROID	Gamma Pacmanicus II						
ANGELES	Nu Robinson VII						
ANGELIC	Trixrabbitus Hathaway X						
ANGIELL	Iota Tyler IX						
ANGUISH	Upsilon Mousketeerus VIII						
ANISEED	Paulreichus Steadwick III						
ANORMAL	Sigma Taylor V						
ANOTHER	Sigma Pelicanus X						
ANTARES	Omega White II						
ANTIFAS	Psi Shafer IV						
AOAAAAA	Chi Paulreiserus V						
APOLLOB	Chi Reaganus VII						
APOLOGY	Omega Martinez VIII						
APPLEPI	Lambda Diverticulus X						
AQBRZEJ	Hippidipsus Thompson VI						
AQQQQQQ	Beta Leprus VII						
AQUJVPN	Kappa Humptydumptus IX						
ARABEST	Nu Khan XI						
ARAGORN	Sigma Hippidipsus VIII						
ARAMADA	Gronulus Wallace I						
ARCANUM	Eta Bananaramus X						
ARDBERG	Epsilon Des Moines VIII						
ARDUINO	Eta Molotov X						
ARIZONA	Epsilon Bubblewrapium IV						
ARKHAMS	Lambda Peterson XI						
AROBASA	Theta Nichols V						
ARRAKIS	Sigma Allopecius XI						
ARRRRRR	Psi Jones VII						
ARSENIC	Theta Crustulus IX						
ARXHCIK	Rho Molotov III						
ASBSSGB	Gamma Lepidopterus IX						
ASDFGHJ	Dominatrix Symington II						
ASSBUTT	Lambda Nelson VI						
ASSWIPE	Tau McNichols XI						
ASTRONA	Eta Jones III						
ATGTQNJ	Nu Hamburguesus I						
ATLANTA	Nu Linoleus VII						
ATOYOTA	Omicron Bearthurus XI						
AUGSTUS	Alpha Lennon I						
AUGUSTI	Iota White III						
AUKECLV	Allopecius McDurkee X						
AVARICE	Zeta Thompson IX						
AVKHKGP	Eta Garcia IX						
AWWAAWW	Diverticulus Romero VII						
AXBXCXD	Pi Pelicanus VII						
AYQAAAH	Theta Corpulus VI						
AZJPBHC	Fustulus King I						
AZQQMWX	Phi Adams I						
AZZZZZZ	Doritus Huxtable XI						
BAAAAAA	Blivebarkerus Nipperus X						
BAAAAAB	Iota Moore IX						
BAAAAAC	Discothecus Clark VII						
BAAAAAD	Delta King IV						
BAAAAAE	Corpulus Reagan X						
BAAAAAF	Upsilon Johnson XI						
BAAAAAG	Mu Fredfordus IX						
BAAAAAH	Discothecus Smith X						
BAAAAAI	Eta Haggard XI						
BAAAAAJ	Cardboardius Hall II						
BAAAAAK	Phi Cartwright III						
BAAAAAL	Pi Romero VIII						
BAAAAAM	Gamma Westinghouse IV						
BAAAAAN	Perfunctus Nite VII						
BAAAAAO	Theta Mills I						
BAAINGS	Pannus Zevon IX						
BAALISM	Beta Pelicanus X						
BAARAMU	Upsilon Draper V						
BABACNO	Omega Smith X						
BABALOO	Kappa McMahon VI						
BABYLON	Crematorius Huxtable III						
BACABAC	Zeta Stemple XI						
BADCATS	Omega Lewis VI						
BADDUDE	Kappa Capulet V						
BADWOLF	Lambda Cancerus IV						
BAGHDAD	Kappa Clinton I						
BALOGNA	Nu Cartwright I						
BALUNGO	Kappa Diggusduggus X						
BANANAS	Omicron Abbrevianus II						
BANDANA	Iota Humptydumptus III						
BARARDO	Iota Humptydumptus III						
BARBARA	Xi Martinez VIII						
BARCODE	Pelicanus Shafer II						
BAROQUE	Rho Dudebaddus V						
BBAAAAA	Mu Salisbury X						
BBBBBBA	Zeta Waldorfus X						
BBBBBBB	Sigma Cartwright I						
BBBBBBC	Nu Crunkuli XI						
BBBBBBD	Cancerus Romero II						
BBORGUP	Nu Nicholson VIII						
BBYWRLD	Cheetus Young XI						
BCAAFFA	Psi Harris XI						
BCBCBCB	Psi Crustulus X						
BCDEFGH	Delta Perfunctus VI						
BDRAGON	Pi Perambulus XI						
BEARSEX	Bellegrandus McDonald II						
BEATLES	Sigma Slobulus XI						
BEAVERS	Rho Rudd VIII						
BEERCAT	Beta Buck VI						
BEFORUS	Iota Stemple VI						
BELEVEN	Alpha Dominatrix XI						
BELUCKY	Psi Young XI						
BERLIOZ	Eta Cardboardius III						
BERUSKI	Iota Milkius VII						
BESPOKE	Eta Sullivan IX						
BESTONE	Phlebitis Brown IV						
BETWEEN	Upsilon Cooper VIII						
BEUZWOD	Eta Mexicanus IX						
BFAAAAA	Alpha Cheetus IV						
BGAAAAA	Mexicanus Stipe II						
BHXEZWP	Phi Saladus XI						
BICYCLE	Alpha Polepositioni VIII						
BIGBANG	Iota Clinton I						
BILLNYE	Nu Goldthwait I						
BISMUTH	Omicron Milkius IX						
BIXUEIU	Eta Allopecius XI						
BJAAAAA	Paulreichus Thompson VIII						
BKAAAAA	Crunkuli Lennon X						
BLOFELD	Epsilon Berry I						
BLOWJOB	Diggusduggus Smith V						
BLUBELL	Omicron Stemple VII						
BLUNDER	Omega Perfunctus VII						
BLUTHCO	Sigma Unicornius II						
BLXCGYJ	Psi Mott X						
BMAAAAA	Tau Cheetus VIII						
BMBAIZW	Hippidipsus Taylor VII						
BNAAAAA	Omega Young V						
BOBSLED	Nu Abbrevianus X						
BOGNORT	Omega Billclintonus X						
BOHRIUM	Phi Goldthwait VIII						
BONKERS	Blivebarkerus Sullivan XI						
BOOBIES	Omega Paulson X						
BOREDOM	Phi Martin VI						
BOSSBAT	Pi Westinghouse IV						
BPHNGJY	Rho Cromulus VI						
BQAAAAA	Chi Reaganus XI						
BRAAINS	Omicron Hippidipsus XI						
BRADLEY	Alpha Buck II						
BREASTS	Nu Draper I						
BRIGAND	Humptydumptus McDurkee I						
BROMINE	Waldorfus Benedict XI						
BSAAAAA	Pacmanicus McCartney XI						
BTXWVWV	Omicron Bush I						
BUGBEAR	Diggusduggus Shafer I						
BUNNIES	Mu Des Moines V						
BUTTONS	Diverticulus Easthouse V						
BUTTSEX	Beta Microscopius VI						
BUVUTHX	Pi Bubblicius IV						
BUZZARD	Misgunus Mott XI						
BUZZING	Lambda Diggusduggus V						
BVAAAAA	Theta Trixrabbitus II						
BWKMCTH	Conjunctivitus Wallace XI						
BXAAAAA	Lambda Harrison VIII						
BXJGIAI	Psi Adams I						
BYAAAAA	Omega Disraeli VI						
BZAAAAA	Lambda Moore VIII						
CAAAAAA	Pacmanicus Miller V						
CABALAS	Sigma Hippidipsus IV						
CABANAS	Upsilon Simon XI						
CABARET	Epsilon Cancerus XI						
CACBCDC	Gamma Conjunctivitus V						
CADAVRA	Alpha Jones VII						
CADENCE	Tau Reaganus XI						
CADMIUM	Corpulus Draper XI						
CALCIUM	Pelicanus Goodman V						
CAMACHO	Iota Washington II						
CAMELOT	Psi Discothecus VIII						
CAMERON	Chi Symington IV						
CANTATA	Doritus Bush V						
CAPALDI	Pi Cattusdoggus I						
CAPTURE	Omega Bubblicius V						
CARBIDE	Scabrus Easthouse X						
CARBINE	Xi Tyler III						
CARCOSA	Iota Tyler IX						
CARNAGE	Unicornius Hall V						
CARTOON	Zeta Wilson VII						
CASHEWS	Zeta Lepidopterus XI						
CASSIDY	Omega Misogynus VI						
CATFISH	Phi Bob XI						
CATLAND	Pi Dominatrix VIII						
CAVORTS	Kappa Salisbury XI						
CAZIRIO	Omicron Des Moines VII						
CBAAAAA	Chi Clinton VIII						
CCCCCCC	Gamma Blivebarkerus VIII						
CDEFGHI	Delta Paulreichus VII						
CDMOYER	Mu Slobulus XI						
CELEVEN	Theta Wallace III						
CELSIUS	Zeta McCartney IX						
CENTRAL	Eta Gromulus XI						
CFAAAAA	Rho Goodman II						
CGINASA	Theta Benedict VII						
CHALUPA	Psi Dominatrix III						
CHAOTIC	Chi Taylor XI						
CHARISM	Bubblicius Westinghouse I						
CHARRED	Lambda Benedict VI						
CHATEAU	Omega Symington II						
CHESTER	Mu Bearthurus III						
CHEVRON	Lambda Fustulus X						
CHORALE	Xi Linoleus X						
CHORIZO	Gamma Dudebaddus XI						
CHRONOS	Beta McDonald IX						
CIAAAAA	Delta Blivebarkerus IX						
CIKPKTM	Waldorfus Thompson II						
CIVACDG	Reaganus Goodman II						
CJAAAAA	Milkius Reagan II						
CKAAAAA	Hippidipsus Allen I						
CLANNIE	Epsilon Smith VI						
CLAUDIA	Pacmanicus Sanford III						
CLAVIER	Phi Mott V						
CLEMENS	Omicron Shafer IV						
CLIMATE	Iota Crustulus XI						
CLOVERS	Rho Reaganus I						
CMAAAAA	Rho Cheetus VIII						
CNAAAAA	Iota Goldthwait V						
CNWGNRR	Tau Billclintonus VIII						
COCOABO	Psi Cartwright VI						
COCONUT	Zeta Thompson I						
COMBOGO	Psi Billclintonus IX						
COMRADE	Theta Fritus VII						
CONDOMS	Zeta Belletaco III						
CONTENT	Gamma Cartwright VIII						
CONTROL	Diggusduggus Stemple VI						
COOKIES	Fustulus Berry X						
COORONG	Omicron Spitzner IV						
COUNCIL	Pi Martinez V						
COVFEFE	Nu Bob XI						
COZINES	Theta Bob VI						
CPPKWON	Psi Garcia XI						
CPRSXBP	Tau Sullivan II						
CQAAAAA	Nu Shafer V						
CQHYHHQ	Iota Mills XI						
CROCSTA	Rho Mott IX						
CRUSHED	Delta Bellegrandus III						
CSAAAAA	Eta Paulreiserus VII						
CTHULHU	Pelicanus Dunn XI						
CTOGHFL	Beta Durden V						
CUCKOLD	Epsilon Cartwright X						
CUMMIES	Xi Thomas IX						
CUMMING	Lepidopterus Sullivan XI						
CUOVYTU	Theta McDonald XI						
CUPCAKE	Tau Sanford VIII						
CURLZMT	Epsilon Khan II						
CVAAAAA	Hamburguesus Nicholson V						
CWAAAAA	Zeta Fredfordus XI						
CXLEZNU	Eta Buck II						
CXLEZNV	Sigma Westinghouse X						
CXOHYXU	Psi Smith IX						
CYBERIA	Tau Billclintonus VII						
CZAAAAA	Gamma Dyxichix V						
DAAAAAA	Xi Pannus IX						
DAAAAAB	Lambda Conjunctivitus VIII						
DAAFAAA	Nu Blivebarkerus XI						
DABBERS	Upsilon Bob II						
DABBING	Delta Gromulus IX						
DABBITY	Sigma Peterson VII						
DACACAD	Zeta Equipajus VII						
DACTYLS	Phi Reynolds VII						
DADADAD	Fritus Thomas VI						
DALLYAA	Dudebaddus Haggard III						
DAMFINO	Mu Bob III						
DANGERE	Iota McMahon XI						
DASBOOT	Chi Hippidipsus IX						
DAVECAT	Slobulus Davis IX						
DBANDIT	Phi Gronulus VIII						
DBEBFJC	Phi Adams X						
DCBABCD	Fritus Thomas VI						
DDDDDDD	Delta Taylor XI						
DDXMZIQ	Trixrabbitus McNichols VII						
DEADJIM	Iota Conjunctivitus I						
DECEIVE	Alpha Des Moines XI						
DEDEDED	Lambda Shafer I						
DEEPSKY	Upsilon Meadows VII						
DEFACED	Pi Diverticulus VII						
DEFGHIJ	Lambda Belvedere IX						
DEFIANT	Mu Cardboardius VII						
DEGLOVE	Xi Stemple X						
DELEVEN	Rho Paulson IX						
DFAAAAA	Kappa Johnson IV						
DGAAAAA	Eta Perambulus I						
DHAAAAA	Omega Benedict II						
DIGNITY	Epsilon McDurkee I						
DINGBAT	Xi Molotov VII						
DISGUST	Pi Hathaway X						
DJAAAAA	Chi Paulreichus IV						
DKKTGXG	Mousketeerus Rudd IX						
DKKWVUG	Omega Cheetus VIII						
DKZLFER	Pi Pelicanus VII						
DLBYIKW	Cardboardius Taylor IV						
DMAAAAA	Xi Discothecus I						
DNAAAAA	Phi Slobulus VI						
DOCTORW	Iota Linoleus VI						
DOGFORT	Xi Polepositioni II						
DOOTDOO	Chi Cooper IV						
DORYFSH	Rho Diverticulus IX						
DOUGLAS	Epsilon Bananaramus X						
DPQQWKJ	Iota Molotov I						
DPQRJNP	Lepidopterus McNichols X						
DPTXYFM	Cardboardius Disraeli IX						
DQAAAAA	Epsilon Abbrevianus III						
DRAGONS	Chi Lepidopterus I						
DRAGOON	Lambda Cromulus V						
DREADED	Kappa Mills IV						
DRIZZIT	Blivebarkerus Williams X						
DRIZZLY	Pacmanicus Smith I						
DRSRSWG	Theta O'Mally II						
DSCHOST	Beta Allopecius I						
DSLPYWG	Omega Draper II						
DTAAAAA	Tau Goodman II						
DUMBASS	Epsilon McMahon I						
DUPVNXQ	Pannus Harris XI						
DVAAAAA	Phi Fritus X						
DWADLER	Sigma Harris IX						
DWTMARG	Upsilon Simon X						
DXAAAAA	Tau Moore IV						
DYCMQLH	Omega Allopecius XI						
DYNAMIC	Misogynus Thompson IX						
DZAAAAA	Gamma Crustulus IV						
EAAAAAA	Alpha McMahon II						
EAAAAAB	Billclintonus Johnson IV						
EAGERER	Reaganus O'Kelly VII						
EAGERLY	Cardboardius Jackson X						
EAGLESZ	Pacmanicus Anderson V						
EASYACE	Hippidipsus Wallace V						
ECEEPVL	Dominatrix Garfield IX						
EEEEEEA	Omega Stemple II						
EEEEEEE	Rho Cancerus I						
EEEEEEK	Omega Davis VII						
EEGEEGR	Hippidipsus Hall V						
EELEVEN	Chi Bush X						
EEVEEON	Upsilon Polepositioni III						
EFGHIJK	Crustulus Harrison IV						
EFHTAIU	Chi Mills I						
EGGBURT	Iota Zevon IV						
EHZWLOM	Billclintonus Meadows IX						
EJBVUNC	Paulreiserus Dunn XI						
EJJJFIE	Pi Nelson II						
ELDRICH	Nu Abbrevianus X						
ELECTRA	Alpha Dudebaddus XI						
ELEGANT	Fustulus Westinghouse XI						
ELEMENT	Dickbutkus Anderson XI						
ELNINHO	Fustulus Berry X						
ELYSIUM	Delta Sanford I						
EMPATHY	Pi Dyxichix X						
ENGLAND	Kappa Tyler XI						
EPSILON	Delta Belletaco VI						
EQUINOX	Delta Mexicanus X						
EREWHON	Lambda White II						
ESPANTS	Mousketeerus Washington II						
ESPLODE	Beta Pannus VII						
ESTONIA	Beta Gronulus X						
EURONDA	Rho Durden VI						
EVENRUE	Tau Perambulus IV						
EXASYNF	Xi Lepidopterus VII						
EXOTECH	Kappa Perfunctus VIII						
EXTREME	Nu DuPree XI						
EXYZIPS	Bob Thomas I						
EYEBALL	Omega Woodward V						
EYEBROW	Nu Wallace IX						
EYESHIT	Theta Bob VI						
EZHEART	Zeta Stemple VIII						
EZZZZZA	Epsilon Wallace V						
EZZZZZB	Epsilon O'Reilly VII						
EZZZZZC	Scabrus Taylor VIII						
EZZZZZD	Lambda Sanford I						
EZZZZZE	Pi Equipajus II						
EZZZZZF	Omicron Billclintonus I						
EZZZZZG	Eta Moore I						
EZZZZZH	Zeta Hernandez V						
EZZZZZI	Belletaco Brooks II						
EZZZZZJ	Phi Romero VI						
EZZZZZK	Sigma Diverticulus IV						
EZZZZZL	Doritus Rudd IX						
EZZZZZM	Epsilon Nicholson VII						
EZZZZZN	Epsilon Buck X						
EZZZZZO	Mu Washington II						
EZZZZZP	Theta Goldthwait IX						
EZZZZZQ	Eta Goldthwait X						
EZZZZZR	Tau Nichols IV						
EZZZZZS	Gamma Paulreiserus IX						
EZZZZZT	Zeta Microscopius II						
EZZZZZU	Conjunctivitus Taylor IV						
EZZZZZV	Eta Tyler XI						
EZZZZZW	Cattusdoggus Thomas XI						
EZZZZZX	Dominatrix Rodriguez X						
EZZZZZY	Iota Crematorius VII						
EZZZZZZ	Alpha Gromulus V						
FAAAAAA	Lambda Cancerus X						
FAAAAAB	Lambda Reynolds V						
FABBEST	Eta Milkius X						
FABEQAA	Omicron Garcia VI						
FAGGOTS	Perfunctus Wilson VI						
FAIREST	Delta Draper II						
FANTASY	Linoleus Thomas IV						
FARAWAY	Beta Belletaco VIII						
FARQUAR	Eta Molotov X						
FARTGAS	Phi Bush I						
FARTMAN	Sigma Cheetus X						
FATHERS	Xi Madison IX						
FBAAAAA	Theta Crunkuli II						
FBDMZRW	Yodeli Lee I						
FBRORUW	Epsilon Fredfordus I						
FELEVEN	Kappa Crematorius VIII						
FFFFFFF	Pi Leprus X						
FFYIVNN	Mu Jackson VIII						
FGHIJKL	Phi Taylor VIII						
FGLDEFI	Psi Nichols III						
FGRVJCU	Equipajus Lennon VII						
FIDZUXQ	Tau Allen VIII						
FINDING	Alpha Pacmanicus VI						
FINLAND	Saladus Capulet XI						
FIREFLY	Kappa Smith X						
FISHIES	Rho Reynolds VI						
FJOOOOX	Gamma Fredfordus XI						
FLAMING	Chi Molotov XI						
FLATGEO	Gronulus Paulson VII						
FLATRTH	Kappa Miller X						
FLEEING	Alpha Bearthurus V						
FLEMISH	Perfunctus Martin VIII						
FLUMMOX	Pi Trixrabbitus I						
FLYTRAP	Molotov Woodward II						
FOEODCX	Tau Bush I						
FOEODXD	Tau Dyxichix IX						
FRAGILE	Upsilon Humptydumptus X						
FRAISER	Bob Franklin III						
FRATORC	Xi Humptydumptus X						
FREEDOM	Omicron Stemple VII						
FRIDAYZ	Kappa Saladus IX						
FRIENDS	Alpha Milkius I						
FROGMAN	Eta Dunn II						
FRYCOOK	Beta Nichols XI						
FUCKYOU	Delta Crustulus IV						
FUGCYDO	Bubblewrapium Woodward VI						
FUNGALI	Theta Mexicanus II						
FUNTIME	Eta Shannahan VI						
FUTURES	Sigma Linoleus VII						
FUZZILY	Sigma Lennon V						
FZZZZZX	Psi Leprus IV						
GAGYGAX	Gromulus Roosevelt I						
GALLIUM	Xi Capulet V						
GARDYLU	Chi Brooks VIII						
GARGOYL	Lambda Fustulus X						
GATEWAY	Alpha Hamburguesus III						
GAYFART	Phi Wallace XI						
GAYPWND	Alpha Dyxichix VII						
GCYKWII	Iota Belletaco IX						
GDHJYWM	Equipajus Haggard II						
GDYUUFS	Delta Diverticulus IV						
GELEVEN	Sigma Nipperus IX						
GEMINIS	Omicron Cancerus X						
GERHILD	Mu Bananaramus XI						
GETDATA	Upsilon Humptydumptus X						
GETJINX	Eta Polepositioni XI						
GFEDCBA	Zeta Taylor VIII						
GFYLNIM	Omega Phlebitis X						
GGGGGGG	Psi Nichols III						
GHASTLY	Omicron Paulreiserus V						
GHIJKLM	Epsilon Fritus V						
GHOSTLY	Psi Wallace V						
GIWMWRF							
GLISTER	Iota Perambulus V						
GLITTER	Xi King III						
GMJSIYD	Nu Dunn IX						
GNNVUTF	Kappa Rodriguez XI						
GNWNTEI	Nu Anderson III						
GOGGLES	Kappa Bob V						
GOTOPAX	Tau Mott II						
GPBRSRL	Tau Goldthwait IX						
GRACIAS	Cancerus Woodward IV						
GRANITE	Bob Woodward IX						
GRAVITY	Iota Saladus XI						
GRAYSON	Waldorfus Wilson X						
GREGORY	Omega Paulreichus II						
GREYCAT	Zeta Crustulus III						
GRIFFIN	Allopecius Brown II						
GRIMACE	Tau Martinez VII						
GRIMDOG	Lambda Mexicanus V						
GRLCRYA	Omega Nipperus VIII						
GTHWAIT	Kappa Bananaramus IV						
GVDPTEK	Pannus Johnson III						
GZAAAAA	Omega Linoleus X						
GZWEAPU	Kappa Stemple XI						
HAAAAAA	Omicron Lee VII						
HAAAAAB	Lambda McDonald XI						
HABITAT	Tau Washington X						
HACKING	Upsilon DuPree VIII						
HADANTE	Delta Khan XI						
HAFNIUM	Eta Williams V						
HAGGARD	Beta Bellegrandus IX						
HALCYON	Phi Waldorfus VII						
HALIBUT	Linoleus Romero IX						
HAMBAGU	Delta Khan XI						
HAMMOND	Chi Cheetus I						
HANSOLO	Chi Dunn IX						
HARAMBE	Omega Adams II						
HARKENS	Sigma Nelson X						
HARMONY	Eta Paulreiserus VII						
HASSIUM	Lambda Moore VII						
HATEBIT	Bubblicius O'Sullivan I						
HATSUNE	Zeta Smith III						
HBMRGMA	Psi Stemple XI						
HBNQWMA	Delta Crematorius VII						
HBZWJQL	Hippidipsus Mills VI						
HDEFINE	Chi Brown V						
HEALTHY	Hamburguesus Stipe XI						
HEGINRB	Sigma Capulet VIII						
HELLBOY	Theta Rodriguez IX						
HEYLADY	Tau Saladus XI						
HFLVIBX	Phi Molotov VI						
HGAQGTL	Dickbutkus Pennington X						
HIJKLMN	Zeta Conjunctivitus III						
HIMMLER	Iota Reaganus I						
HIPSTER	Rho Nelson I						
HITHERE	Iota Dyxichix VII						
HJFSFFG	Psi McDurkee I						
HKPYFCX	Gronulus Franklin X						
HKZQDFC	Upsilon Cardboardius III						
HLUMDHT	Sigma Bearthurus XI						
HMOFFLJ	Gromulus Stipe V						
HOBBITS	Bearthurus Young VII						
HOBOKEN	Linoleus Williams V						
HODGMAN	Sigma Linoleus XI						
HODRBVO	Theta Huxtable II						
HOLIDAY	Nu Stipe VII						
HOLMIUM	Iota Allopecius VII						
HORIZON	Eta Bubblewrapium II						
HOTDOGS	Xi Miller I						
HOUSTON	Bob Franklin VIII						
HPGXDQD	Beta Noriega IX						
HTQMRWP	Zeta Dudebaddus I						
HTRFLZE	Eta Paulreiserus XI						
HVLELCV	Upsilon Hernandez V						
HYBORIA	Gamma Microscopius VI						
IAAAAAA	Linoleus Jones IV						
IAMZUUL	Alpha Phlebitis II						
IDIANYN	Bellegrandus Goldthwait V						
IGULTSE	Kappa Fustulus XI						
IIIIAAA	Gromulus O'Sullivan VIII						
IIIIIII	Phi Blivebarkerus VIII						
IIIIOOO	Tau Reaganus V						
IIIOIOO	Theta Tyler III						
IIIOOIO	Omicron Saladus I						
IIIOOOI	Rho Saladus XI						
IIOIIOO	Omicron Saladus I						
IIOIOIO	Rho Saladus XI						
IIOIOOI	Lambda Capulet VIII						
IIOOIIO	Lambda Capulet VIII						
IIOOIOI	Psi Stipe IV						
IIOOOII	Zeta Diggusduggus XI						
IJJVPLF	Rho Perambulus IX						
IJKLMNO	Upsilon Cartwright VII						
IMGLMOO	Upsilon Cartwright VII						
IMGROOT	Lambda Milkius II						
IMHOTEP	Kappa Dominatrix XI						
IMPEACH	Eta O'Kelly I						
IMPETUS	Eta Slobulus V						
IMPULSE	Equipajus Waldorf IX						
IMZUNOR	Phi Hall XI						
INEMMOO	Upsilon Cartwright VII						
INJECTS	Zeta Cromulus III						
IOIIIOO	Rho Saladus XI						
IOIIOIO	Lambda Capulet VIII						
IOIIOOI	Psi Stipe IV						
IOIOIIO	Psi Stipe IV						
IOIOIOI	Zeta Diggusduggus XI						
IOIOOII	Cheetus Westinghouse IV						
IOOIIIO	Zeta Diggusduggus XI						
IOOIIOI	Cheetus Westinghouse IV						
IOOIOII	Pi O'Sullivan VII						
IOOOIII	Chi Thomas II						
IRABABY	Tau Doritus IX						
IRIDIUM	Lambda Huxtable IX						
IRONMAN	Allopecius Khan VI						
ISATRAP	Omega Nipperus VIII						
ISTHMUS	Linoleus Stemple X						
ITCHBOX	Omega Hippidipsus IX						
ITOTEMI	Phi Pacmanicus I						
ITSFLAT	Sigma Young II						
ITSMEEE	Gamma Polepositioni II						
IUVOCCE	Cancerus Garcia I						
IXIFMRP	Lambda Westinghouse XI						
IXIIXII	Omicron Perfunctus VII						
JAAAAAA	Delta Brooks XI						
JACDEFG	Mu Reagan IV						
JACKSON	Omega Microscopius III						
JAIVLGR	Gamma Lee VII						
JAMOKER	Psi Isaacson X						
JASMINE	Pi Easthouse VI						
JAZZMAN	Equipajus Sullivan IV						
JEBANNA	Gamma Madison XI						
JEDIJED	Nu Shafer VI						
JERERRY	Dudebaddus Capulet IV						
JGYUUAT	Phi Crematorius I						
JICKPEE	Kappa Fredfordus IX						
JJJJJJJ	Psi Bob IV						
JKLMNOP	Upsilon Madison VII						
JLTJOPX	Theta Thomas XI						
JNXEPBD	Dudebaddus Khan I						
JOERGER	Beta Diverticulus VII						
JOHNSON	Pacmanicus Hall XI						
JOHNWIW	Phi Nite VII						
JOLLIES	Delta Perfunctus II						
JOURNAL	Sigma Unicornius II						
JOZXYQK	Eta Misogynus II						
JQIYVMP	Delta Microscopius X						
JTOEBES	Omicron Gromulus IX						
JUGULAR	Pi Waldorfus VIII						
JULIEZS	Delta Harris VIII						
JUPITER	Upsilon Corpulus V						
JUSTINA	Zeta Fredfordus VI						
JVRVJES	Crunkuli Reagan X						
JYSFSJC	Gamma Dunn XI						
KAAAAAA	Chi Perambulus XI						
KAAAAHN	Rho Doritus III						
KADABRA	Kappa Gromulus VII						
KAIPRLS	Pi Pacmanicus II						
KALADSH	Discothecus Johnson I						
KALALEQ	Phi Easthouse VII						
KBTOTLT	Epsilon Phlebitis VI						
KCIPAYY	Xi Smith VI						
KCOEOQK	Zeta Conjunctivitus III						
KCRVJWW	Xi Adams VI						
KDEIXHK	Dyxichix Johnson VI						
KDXSZOC	Rho Tyler X						
KEDAVRA	Alpha Harris III						
KELEVEN	Dyxichix Martinez X						
KELPIES	Paulreiserus Dunn XI						
KERMITS	Omicron Corpulus V						
KICKASS	Alpha Pacmanicus IV						
KILLERZ	Gamma Billclintonus VIII						
KIMJONG	Hippidipsus Draper VIII						
KINGDOM	Gamma McCartney V						
KINMOZA	Pannus Lennon XI						
KITTIES	Upsilon Williams III						
KJVLLMT	Iota Capulet VI						
KKAQCBU	Omicron Stemple VII						
KKXKSSZ	Chi Jackson XI						
KLMNOPQ	Hamburguesus Young II						
KMFKCBJ	Xi McMahon VII						
KNEMGUR	Pi Draper IX						
KNOWING	Pi Goldthwait III						
KOBOLDS	Xi Anderson XI						
KOLCONI	Mu Garcia XI						
KOLWIKI	Fustulus III						
KOOPERM	Sigma Young XI						
KOPIJOL	Nu Brooks V						
KRAMPUS	Hippidipsus Noriega VI						
KRYPTON	Chi Humptydumptus VII						
KUKURYY	Delta Mills VII						
KUOVASH	Bubblicius Disraeli V						
KVCKCRW	Upsilon Madison VII						
KWWWWWK	Eta Moore IV						
KZOOKYS	Beta McDonald IX						
KZPFTIC	Psi Mousketeerus II						
KZVINAU	Delta Brown V						
LAAAAAA	Omega O'Kelly VIII						
LAAAAME	Zeta Pacmanicus II						
LABELLE	Iota Buck II						
LABIATZ	Pannus Jackson III						
LACRIMA	Chi Scabrus IX						
LALALAL	Rho Mack V						
LANGARA	Chi Phlebitis VI						
LAZARUS	Kappa Smith I						
LEATHER	Psi Nichols IV						
LEGOLAS	Beta Steadwick V						
LEONINE							
LEOPOLD	Mu Misogynus I						
LIBERTY	Pi Doritus III						
LICENSE	Pi Jackson IV						
LINDSAY	Upsilon Cartwright VII						
LINDSEY	Billclintonus Durden III						
LITHIUM	Xi Rudd X						
LKJUFUV	Eta Diverticulus VI						
LLLLLLL	Phi Blivebarkerus VI						
LMNOPQR	Iota Abbrevianus VIII						
LOATHIN	Diggusduggus Smith V						
LOLOLOL	Crunkuli Draper X						
LOVEKOL	Trixrabbitus Waldorf V						
LPNOITN	Xi Wallace VIII						
LQOPGOM	Iota Fritus I						
LQZQEJS	Upsilon Symington XI						
LRXREJS	Upsilon Symington XI						
LUCIFER	Lambda Lepidopterus X						
LULLABY	Chi Hathaway XI						
LUMBAGO	Alpha Hamburguesus IX						
LVXFTYW	Alpha Bubblicius VI						
LWQLYXV	Pi Fustulus I						
LYNXIAS	Chi Clark VII						
LYTHELY	Delta Bubblicius IX						
LYXUDRY	Epsilon Jackson VIII						
MAAAAAA	Psi Lewis IX						
MACHINE	Rho Franklin XI						
MADNESS	Xi Capulet V						
MADONNA	Xi Linoleus X						
MADRONA	Delta Scabrus IV						
MAESTRO	Gamma Molotov V						
MALEFIC	Lambda Shatner VIII						
MAMAMIA	Mu King X						
MANANAZ	Phi Mott V						
MANATEE	Kappa Fredfordus IX						
MANGOES	Polepositioni McDonald X						
MANHDNT	Psi Humptydumpus I						
MARTIND	Mu Misogynus I						
MCSROIW	Beta Davis V						
MCSTUMP	Xi Berry X						
MCSUSNP	Xi Berry X??						
MCSUTNP	Trixrabbitus Young IX						
MCVGILR	Upsilon Walker VI						
MEANING	Alpha Pacmanicus VI						
MEASURE	Rho Fritus X						
MELINOE	Chi Reaganus VII						
MELISSA	Phlebitis White V						
MELONIA	Gamma King II						
MERCURY	Zeta Bush VI						
MERONAT	Iota Diverticulus III						
METROID	Theta Misogynus II						
MGKTCOF	Diggusduggus O'Sullivan III						
MGXOWLU	Lambda Nicholson IV						
MICHAEL	Zeta Wilson XI						
MIDGARD	Upsilon Brooks VI						
MINSTER	Eta Fustulus II						
MIOZNKA	Psi Wallace III						
MISFITS	Omicron Haskell III						
MISTAKE	Delta Young III						
MITTENS	Omega Discothecus VIII						
MMMMMMO	Equipajus Johnson I						
MMORPGS	Lambda Woodward V						
MNDURZO	Psi Woodward VII						
MNOPQRS	Theta Black V						
MONSTER	Pi Washington II						
MOONIES	Mexicanus Jones IV						
MORAGIV	Pi Lennon IV						
MORLOOT	Humptydumptus Lennon VIII						
MRDARCY	Saladus Harris X						
MRSKULL	Milkius Smith III						
MRSPOCK	Doritus Hathaway XI						
MUTANTS	Rho Jones XI						
MVEWHVF	Sigma Garfunkel III						
MVXWZFB	Zeta Rudd III						
MYBITCH	Bubblewrapium McNichols VII						
MYTOWEL	Misogynus Nicholson VIII						
MZUENJC	Phi Cancerus V						
NAAAAAA	Omicron Des Moines XI						
NARDOLE	Scabrus Allen VI						
NASALIE	Kappa Isaacson VI						
NATURAL	Nu Lewis IX						
NAUGHTY	Psi Conjunctivitus VIII						
NAZISAU	Allopecius Noriega X						
NEBULAE	Zeta Westinghouse IV						
NEMESIS	Omicron Equipajus IX						
NEPTUNE	Equipajus Waldorf IX						
NEWCOCK	Psi Slobulus V						
NEWYORK	Zeta Salisbury IV						
NFXJBTY	Delta Nite IV						
NGMJOKB	Humptydumptus Disraeli X						
NICEASS	Iota Phlebitis XI						
NIGERIA	Psi Smith II						
NIGHTLY	Microscopius Shatner II						
NINNIES	Omega Nipperus VIII						
NIOBIUM	Fredfordus Shafer XI						
NIPPLES	Eta Crustulus III						
NLMMXZL	Gamma Shannahan X						
NNHWNNN	Rho Perambulus X						
NOGOCOR	Goldthwait Garfunkel XI						
NOMBIES	Tau Bob VII						
NONBIER	Eta Fustulus VI						
NOOOOOO	Tau Dyxichix VII						
NOPQRST	Alpha O'Reilly V						
NORBERT	Fritus Salisbury I						
NPJLFMZ	Psi Steadwick VIII						
NPKQKBK	Zeta Dyxichix III						
NVJRPCE	Cheetus Dunn IX						
NYANCAT	Iota Harrison V						
OAAAAAA	Chi Robinson XI						
OBNOXIA	Delta Symington VI						
OBSIDIA	Theta Young III						
OCTOBER	Epsilon Wallace VI						
OCTOPUS	Iota Dudebaddus III						
OFFSITE	Sigma King X						
OFMGZUQ	Discothecus Berry V						
OHFFSYK	Upsilon Haskell III						
OIIIIOO	Lambda Capulet VIII						
OIIIOIO	Psi Stipe IV						
OIIIOOI	Zeta Diggusduggus XI						
OIIOIIO	Zeta Diggusduggus XI						
OIIOIOI	Cheetus Westinghouse IV						
OIIOOII	Pi O'Sullivan VII						
OIOIIIO	Cheetus Westinghouse IV						
OIOIIOI	Pi O'Sullivan VII						
OIOIOII	Chi Thomas II						
OIOOIII	Rho Lee VII						
OJNQXVR	Bob Noriega XI						
OLDCWSA	Tau Bob VII						
OLDCWSB	Iota Allopecius VI						
OLDCWSC	Lambda Saladus IX						
OLDCWSD	Lambda Gromulus VI						
OLDCWSE	Yodeli Draper VI						
OLDCWSF	Discothecus Shafer X						
OLDCWSG	Eta Crustulus IV						
OLDCWSH	Iota Walker X						
OLDCWSI	Phi Scabrus X						
OLDCWSJ	Epsilon Dominatrix XI						
OLDCWSK	Mu Taylor X						
OLDCWSL	Lambda White II						
OLDCWSM	Lambda Madison VI						
OLDCWSN	Iota Perambulus V						
OLDCWSO	Zeta Cartwright V						
OLDCWSP	Tau Goldthwait IX						
OLDCWSQ	Sigma O'Reilly XI						
OLDCWSR	Mousketeerus Washington II						
OLDCWSS	Omicron Corpulus V						
OLDCWST	Blivebarkerus Mott XI						
OLDCWSU	Trixrabbitus McNichols VII						
OLDONES	Gamma Dickbutkus V						
OLDPUSS	Psi Shafer III						
OLYMPIC	Rho Benedict VI						
OMICRON	Omicron Spitzner IV						
OMINOUS	Nu Dominatrix II						
ONEMORE	Gamma Sanford III						
ONQUHBM	Zeta O'Kelly VII						
OOIIIIO	Pi O'Sullivan VII						
OOIIIOI	Chi Thomas II						
OOIIOII	Rho Lee VII						
OOIOIII	Xi Shafer III						
OOOIIII	Psi Mexicanus VIII						
OOOOOOH	Gamma Leprus I						
OOOOOOO	Dominatrix Haggard I						
OPQRSTU	Iota Shafer IX						
ORGASMS	Pi Pacmanicus VII						
ORLWPSB	Kappa Peterson III						
ORVILLE	Omicron Perambulus III						
OSTRICH	Tau Thompson VI						
OTIKIFM	Tau Dominatrix XI						
OTSDHZP	Billclintonus Wallace V						
OUWEOMQ	Upsilon Pelicanus IV						
OXIDIZE	Nu Pannus IV						
OYSTERS	Nu Dunn VI						
OZCXVCT	Chi Abbrevianus V						
OZTZNWD	Pi Bearthurus X						
PAAAAAA	Pi Easthouse IV						
PAJAMAS	Slobulus O'Reilly IV						
PANDORA	Molotov Black V						
PARTIAL	Mu Harrison VIII						
PEACHES	Microscopius Draper VIII						
PEGASUS	Kappa Bob III						
PEIWBLE	Humptydumptus Disraeli X						
PENGUIN	Iota Diverticulus III						
PERVERT	Omega Microscopius X						
PEXTOLR	Pi Thompson VI						
PEYIMKV	Rho Mexicanus II						
PHOENIX	Beta Stemple I						
PHYSICS	Iota Jones V						
PICKLES	Lambda Meadows III						
PIRATAS	Chi Cattusdoggus IX						
PIRATES	Beta Cooper XI						
PIRATZS	Tau Harris V						
PIRTRJS	Pi Thompson VI						
PISTOLS	Pi Thompson VI						
PITYFUL	Xi Adams XI						
PLACEBO	Theta Equipajus II						
PLANETX	Gamma Slobulus X						
PLANEXX	Zeta Allopecius VI						
PLASTIC	Lambda Lewis X						
PNSFYHO	Waldorfus Romero IV						
POBCQXG	Theta Nite II						
POKEFAM	Pi Garfield IV						
POKEMON	Psi Nicholson IV						
POLECAT	Pi Waldorfus II						
PORNHUB	Eta Bellegrandus IV						
POVERTY	Alpha Sanford VI						
PQRTSUV	Chi Huxtable IV						
PRAXYON	Billclintonus Sullivan I						
PRELUDE	Nu Sullivan VII						
PRICKLY	Kappa Harris VIII						
PRMUDPC	Chi Paulreiserus VI						
PROBLEM	Pi Isaacson X						
PSSHKJN	Paulreichus Stipe VI						
PUIKOWB	Paulreichus Stipe VI						
PVUMXYA	Zeta Wallace VIII						
PWMFFJA	Leprus Jones IX						
PXNXUMQ	Iota Perfunctus XI						
PZBYWQC	Gamma Sanford VI						
QAAAAAA	Beta Pacmanicus V						
QABWYAU	Upsilon Haskell III						
QBQBQBQ	Omega Montague IV						
QICHEDR	Xi Waldorf X						
QJOLPZG	Blivebarkerus Westinghouse III						
QJYYPXQ	Beta Bellegrandus XI						
QKIAAGD	Iota Smith VIII						
QLIXDME	Omega Mexicanus VIII						
QMRSOCN	Phi Diggusduggus VI						
QQQQQQQ	Beta Gronulus XI						
QRSTUVW	Alpha Mexicanus IX						
QUARTET	Tau Durden VIII						
QUAZARS	Theta Dominatrix I						
QUENDOR	Zeta Linoleus XI						
QUINCYJ	Alpha Bananaramus IX						
QUINTET	Eta Conjunctivitus VI						
QYYYBBY	Iota Saladus XI						
RAAAAAA	Sigma Mousketeerus IX						
RACHELS	Saladus Nelson IX						
RACISTS	Nu Crematorius IX						
RACKIST	Alpha Robinson IX						
RALPHIE	Kappa Dyxichix III						
RAMONES	Pacmanicus Brown VII						
RATFINK	Cheetus Belvedere XI						
RBWPBCZ	Alpha Pennington X						
RECITAL	Nu Mexicanus II						
REPRISE	Zeta King IX						
REQUIEM	Lambda Durden V						
RGCKPTF	Yodeli Draper VI						
RHODIUM	Gronulus Stemple VIII						
RHZXOPJ	Pi Dyxichix X						
RICHMAN	Milkius O'Mally III						
RICKETS	Lambda Slobulus IX						
RIFFLES	Tau Symington VII						
RITARDS	Epsilon King VI						
RJRZEME	Omicron Billclintonus XI						
RLVSMIY	Chi Saladus VI						
ROBBERT	Cheetus Smith V						
ROFLMAO	Zeta Thomas II						
RONALDO	Iota Buck V						
RPHHMUE	Rho Diggusduggus XI						
RPNFQEN	Nu Reaganus VI						
RQJEGGI	Iota Conjunctivitus XI						
RSRSZZG	Omega Cancerus IV						
RSTBVWX	Theta Blivebarkerus IV						
RSTUVWX	Gamma Goldthwait II						
RSZBSBM	Upsilon Microscopius IV						
RTCZBLM	Omicron Nipperus IX						
RUDOLPH	Omicron Nipperus IX						
RWCMYFV	Iota Durden IV						
RWMIUUB	Sigma McDurkee II						
RYFSGEO	Psi Johnson VIII						
SAAAAAA	Omega Lepidopterus II						
SAMUELH	Gamma Hall I						
SARUKEN	Pi Stemple XI						
SARUMAN	Tau Crematorius XI						
SATURNV	Lambda Nicholson IV						
SAYYOHO	Psi Noriega X						
SBRKBCH	Chi Belvedere I						
SCHERZO	Rho Roosevelt X						
SCIENCE	Phi Brown VI						
SCUMBAG	Bubblewrapium Benedict XI						
SEATTLE	Sigma Pacmanicus VIII						
SELENIS	Sigma Smith VII						
SEVERUS	Beta Thompson I						
SEXDOLL	Delta Easthouse VII						
SEXIEST	Sigma Meadows VIII						
SEXPORN	Gamma Allopecius III						
SEXSLAV							
SEXSLUT	Xi Reaganus V						
SEXYFUN	Mu Humptydumptus III						
SEXYHUH	Sigma Belletaco IX						
SEXYMAN	Delta Thompson III						
SEXYOUP	Alpha Blivebarkerus II						
SEXYSEX	Delta McDonald VI						
SFFLIJK	Chi Reaganus IV						
SHATNER	Pi Lennon IV						
SHOOTER	Alpha Cooper VI						
SIDHVFO							
SILENCE	Theta Washington IV						
SILICON	Pi O'Sullivan VII						
SIMARKA	Pi Hippidipsus VI						
SKHQWKL	Diverticulus Garcia XI						
SKITTER	Tau Durden VIII						
SLTEXVI	Gromulus McNichols VII						
SMLLAFA	Eta Diggusduggus IV						
SOPRANO	Upsilon Romero VIII						
SPANKME	Pi Pelicanus II						
SPARKLE	Nu Microscopius V						
SPATULA	Eta Bubblewrapium VIII						
SPELUNK	Pi Dudebaddus XI						
SPINNER	 Blivebarkerus Mack VIII						
SPOODER	Iota Mack III						
SPSJBEG	Misogynus Smith I						
SPUTNIK	Alpha Dominatrix XI						
SQDUVHY	Mu Perfunctus I						
SROLGKA	Phi Lepidopterus I						
SSSSHHS	Phi Polepositioni VII						
SSSSSSS	Upsilon Waldorf IX						
STARWAR	Reaganus DuPree XI						
STATION	Chi Gromulus VII						
STEWART	Eta Yodeli VIII						
STRIDER	Fustulus Sanford VI						
STUVWXY	Nu Crustulus XI						
SUCKERS	Cromulus Adams XI						
SUREETA	Delta Gromulus X						
SUWOZMO	Upsilon Jones IX						
SXXJPPG	Eta Moore VII						
SYGWQBP	Psi Bellegrandus VIII						
SYSYCNH	Upsilon Symington XI						
SZCZCWA	Upsilon Paulson XI						
SZPOXSK	Omicron Des Moines IV						
TAAAAAA	Chi Crunkuli VII						
TAGURIT	Chi Pennington IV						
TALLINN	Lambda Cooper III						
TALTHIS	Perfunctus Rudd VII						
TARJSFJ	Lambda Yodeli VI						
TARJSTJ	Phlebitis Williams IV						
TATGHSG	Lambda Diggusduggus I						
TATGHSH	Kappa Perambulus I						
TBEYOND	Xi Crunkuli II						
TCJGHKH	Theta Doritus XI						
TDJMFWR	Crematorius Garcia V						
TDPIGZX	Tau Smith II						
TELEFON	Eta Lennon VII						
TEMPLES	Nu Saladus VIII						
TENNANT	Gronulus Stemple VIII						
TEQUILA	Diverticulus Meadows VII						
TERBIUM	Sigma Yodeli V						
TESTING	Iota Nite III						
TFGJHDG	Gromulus Johnson IX						
TFHSXKK	Gronulus Smith IV						
TFQNBPU	Bananaramus Garfunkel IX						
TGKXOEU	Blivebarkerus Westinghouse III						
THEAPES	Gamma Polepositioni III						
THERMAL	Lambda Cardboardius II						
THERMIA	Gamma Dominatrix VIII						
THIRTYG	Iota Smith VI						
THORIUM	Omicron Johnson IV						
THULIUM	Zeta Pelicanus VI						
TIJUANA	Gamma Polepositioni II						
TIMEWAR	Xi North VII						
TJSYRJS	Theta Rodriguez VI						
TLONMCY	Allopecius Jones II						
TMPGWWM	Tau Garfunkel IX						
TNQRPFC	Omega Goldthwait II						
TOLLANA	Waldorfus Stemple V						
TOOTSIE	Xi Phlebitis VII						
TOOTSZE	Psi McMahon V						
TORTUGA	Iota Bearthurus I						
TPERFEC	Sigma Reaganus VIII						
TQSYRKD	Nu Yodeli VII						
TQUPOCO	Omicron Johnson III						
TRANSEX	Conjunctivitus Stemple X						
TREMOLO	Chi Gromulus VII						
TRITONE	Pi Goodman XI						
TRKHEBR	Yodeli Bush IV						
TROIONE	Beta Haggard II						
TSYQRSZ	Delta Taylor III						
TTJTGHY	Alpha Stemple XI						
TTVARBZ	Phi Brown V						
TUJBQTK	Unicornius Reynolds VII						
TUMBLER	Alpha Fustulus XI						
TURTLET	Discothecus Sanford IV						
TUXTUST	Pi Fritus II						
TUXTUXT	Omicron Cooper IV						
TUXTUXU	Zeta Sullivan XI						
TUXUUXT	Upsilon Shafer XI						
TUXVUXT	Rho Cattusdoggus I						
TUXWUXT	Upsilon Dudebaddus III						
TUXXUUT	Dyxichix Zevon IV						
TUXXUVT	Chi Waldorf VI						
TUXXUWT	Chi Anderson V						
TUXXUXT	Phi Misogynus I						
TUXXUYT	Iota Unicornius IV						
TUXYUXT	Rho Reaganus XI						
TWIRLYR	Alpha Perambulus VI						
UAAAAAA	Chi Belvedere VII						
UAUUQHS	Billclintonus Wallace V						
UBWYUZQ	Lambda Noriega VIII						
UKLSKQJ	Unicornius Reynolds VII						
ULTMGSE	Humptydumptus Capulet X						
UMQWLEV	Lambda Mousketeerus X						
UNDYING	Upsilon Billclintonus V						
UNGODLY	Theta Dickbutkus XI						
UNICORN	Mu Conjunctivitus VIII						
UOQNLTR	Theta Thomas V						
UPSILON	Pi Cattusdoggus XI						
URANIUM	Zeta Pennington V						
URETHRA	Omicron Clinton V						
URINOUS	Delta Pelicanus VII						
URSINES	Humptydumptus Brooks XI						
UUUUUUU	Iota Humptydumptus XI						
UVTUPWO	Lambda White III						
UVWXYZA	Bearthurus Steadwick XI						
UXIEAIA	Chi Fustulus II						
UXNNVPG	Pacmanicus Smith VIII						
UXXXOYY	Phlebitis Walker IV						
UYYLGAI	Upsilon O'Sullivan I						
VAAAAAA	Eta Crunkuli VII						
VANESSA	Xi Goldthwait XI						
VAVBVCV	Rho Shafer XI						
VBHGYTF	Alpha Pennington X						
VDCTSXM	Discothecus Stemple V						
VERAGER	Belletaco Wilson IX						
VERISCA	Cardboardius Thompson IX						
VFMTQZT	Pi Trixrabbitus IV						
VGBNQOB	Crematorius McDonald II						
VICIOUS	Pi Isaacson IV						
VINEGAR	Psi Paulreichus III						
VISUBAN	Nu Mack VI						
VNZMBSP	Delta Trixrabbitus IV						
VOLCANO	Phebitis Martin XI						
VOYAGER	Theta Thompson IV						
VQFQOEJ	Gamma Dunn XI						
VQFQOJS	Upsilon Symington XI						
VUGGLEY	Sigma Garfunkel III						
VVVVVVV	Tau Bellegrandus V						
VWXYZAB	Omega Dominatrix III						
VZDWTHF	Zeta Taylor V						
WAAAAAA	Theta Mack VI						
WALDORF	Eta Goldthwait VI						
WALLABY	Phi Garcia XI						
WANKERS	Psi Microscopius II						
WARBEAR	Nu Zevon III						
WAYIIVW	Delta Slobulus VII						
WBHTUAB	Fustulus Miller X						
WEASLEY	Alpha Nichols III						
WEEABOO	Nu Robinson II						
WEIRDAL	Omega Misogynus VI						
WESTLEY	Iota McMahon VI						
WETTEST	Omicron Wilson IV						
WHATTHE	Cattusdoggus Jones VIII						
WHAZZUP	Epsilon Crunkuli VI						
WHISKEY	Zeta Humptydumptus VIII						
WILDMAN	Gamma White VI						
WINDOWS	Cardboardius Martin III						
WLQHPHB	Cromulus Haskell VI						
WOFADSF	Beta Nelson I						
WRAITHS	Kappa Bearthurus X						
WRETODB	Rho Hippidipsus XI						
WUKJBQY	Zeta Rodriguez VI						
WWWWWWW	Phi Clark VIII						
WWXKILY	Psi Pacmanicus VIII						
WXABCXJ	Mu Diverticulus IX						
WXYZABC	Sigma Woodward II						
WYVERNS	Pi Taylor IV						
WZVHEZF	Saladus Peterson X						
XAAAAAA	Dickbutkus Meadows IV						
XAAYZZB	Iota Adams V						
XAOMTLN	Omega Pacmanicus VIII						
XDSHMHT	Rho Smith V						
XELAYAN	Rho Rodriguez I						
XFRYLWS	Rho Waldorfus V						
XGCBHEC	Delta McMahon X						
XLOCQGO	Tau Lee VII						
XNLIKUK	Lambda Mott V						
XOXOXOX	Iota Unicornius I						
XQGUWNL	Nu Bearthurus IV						
XSWNBGL	Crunkuli Robinson III						
XTQDWEE	Eta Woodward II						
XXDUANJ	Alpha Billclintonus X						
XXXPRON	Bellegrandus Garfunkel XI						
XXXXXXX	Crunkuli Sanford IX						
XYZABCD	Omega Fritus VIII						
YAAAAAA	Chi Lewis IV						
YADMDBI	Mu Microscopius IX						
YARBLES	Phi Wilson VIII						
YAYJICK	Tau Unicornius III						
YBQNPAO	Tau Paulreiserus II						
YCNDGWT	Nu Pelicanus V						
YELLOWS	Delta Benedict VI						
YESSSSS	Alpha Polepositioni IX						
YHCIKNL	Sigma Bananaramus VII						
YHKJOJI	Omega Des Moines V						
YHVQQAF	Nu Harris VIII						
YMEKDCX	Delta Crustulus VI						
YOGHURT	Kappa Clark VI						
YOTSUBA	Beta Stemple III						
YOUPORN	Epsilon Sanford VIII						
YOUSUCK	Phi White IV						
YOYOYOS	Omega Cardboardius IX						
YPQXXPB	Kappa McDonald I						
YTTRIUM	Beta Equipajus XI						
YVFMJHK	Nu Cromulus V						
YXQKHZO	Phi Rudd IX						
YYXAAAB	Upsilon Cromulus IV						
YYYYYYY	Pelicanus McNichols VII						
YZABCDE	Rho Steadwick III						
YZZZZZZ	Chi Brown VI						
ZAAAAAA	Psi Harris V						
ZAAAAAB	Alpha Microscopius XI						
ZAAAAAC	Alpha Haskell I						
ZAAAAAD	Polepositioni Tyler IV						
ZAAAAAE	Dyxichix Taylor X						
ZAAAAAF	Gamma Shannahan X						
ZAAAAAG	Gamma Doritus I						
ZAAAAAH	Epsilon Davis IV						
ZAAAAAI	Xi Spitzner XI						
ZAAAAAJ	Dominatrix Cooper XI						
ZAAAAAK	Rho Leprus II						
ZAAAAAL	Lambda Conjunctivitus VIII						
ZAAAAAM	Mu Miller XI						
ZAAAAAN	Alpha Draper IX						
ZAAAAAO	Theta Moore III						
ZAAAAAP	Iota Martin VII						
ZAAAAAQ	Theta Hamburguesus X						
ZAAAAAR	Phi Cancerus IX						
ZAAAAAS	Omicron Dunn XI						
ZAAAAAT	Beta Goodman VI						
ZAAAAAU	Zeta Pelicanus IV						
ZAAAAAV	Iota Harris VII						
ZAAAAAW	Eta Pelicanus X						
ZAAAAAX	Pi Nelson II						
ZAAAAAY	Pi Haskell VII						
ZAAAAAZ	Belletaco O'Kelly X						
ZAAAABA	Beta Fritus VIII						
ZAAAEUN	Rho Johnson VIII						
ZAAAMMN	Allopecius Brown II						
ZAAANLN	Mousketeerus Nichols V						
ZAAAUEN	Scabrus Allen VI						
ZABCDEF	Delta Berry VI						
ZABGDFG	Tau Cromulus X						
ZABIYOY	Beta Leprus VII						
ZACATTA	Billclintonus Jones XI						
ZACHARY	Theta Franklin VII						
ZAERYHY	Nu Waldorfus VI						
ZAFGHDG	Theta Humptydumptus III						
ZAGGLER	Delta Sullivan VIII						
ZAHADHF	Dominatrix Bush XI						
ZAHFDRF	Theta Lepidopterus IX						
ZAILIFF	Zeta Thompson VIII						
ZALAFEL	Phi Nipperus I						
ZAPATOS	Nu Scabrus V						
ZAPHODS	Nu Bearthurus III						
ZAPPING	Omicron Hathaway XI						
ZAPZAPP	Gamma Harrison IV						
ZARATRU	Lambda Young IX						
ZARQUON	Iota Thompson III						
ZASASDS	Pi Shafer XI						
ZATHRAS	Nu Sullivan I						
ZATHURA	Doritus Hathaway XI						
ZAZAZAZ	Sigma Goldthwait VII						
ZBAAMMM	Waldorfus White V						
ZBANDER	Lambda Slobulus IX						
ZBARTZZ	Cardboardius Reagan VII						
ZBBBBBB	Iota Adams III						
ZBETNYA	Tau Nichols V						
ZBOBBOB	Nu Stemple VI						
ZCCCCCC	Sigma Bubblicius XI						
ZCHMUCK	Mu Diverticulus II						
ZDASGDE	Cattusdoggus Smith IX						
ZDDDDDD	Eta Cancerus VIII						
ZDERPYZ	Sigma Bananaramus IV						
ZDNPXVK	Nu Berry IX						
ZDOCWHO	Omega Lennon V						
ZDONALD	Psi Milkius XI						
ZDPZQGQ	Sigma North VI						
ZDPZSCS	Sigma North VI						
ZDRDDRD	Trixrabbitus Berry VII						
ZDRYHAD	Epsilon Dickbutkus VI						
ZDTGYIO	Alpha Jackson XI						
ZEALAND	Tau Romero X						
ZEALOTS	Beta Harris V						
ZEBEDEE	Chi Mott I						
ZEBLUES	Phi Nichols XI						
ZEEEEEE	Crunkuli O'Sullivan III						
ZEIRDAL	Mu Dudebaddus VII						
ZELAZNY	Psi Diggusduggus IV						
ZEMPHIS	Cheetus Dunn XI						
ZENDIKR	Crustulus Buck IX						
ZEPHYRS	Pi O'Mally X						
ZEPPLIN	Rho Montague IV						
ZEQLMNZ	Saladus Madison VIII						
ZERODAY	Sigma Hippidipsus VIII						
ZERPENT	Tau Discothecus VII						
ZESTFUL	Lambda Roosevelt XI						
ZESTIES	Phi Abbrevianus XI						
ZETHREE	Mu Cromulus II						
ZEWFAKS	Theta Dudebaddus II						
ZFAAIQI	Scabrus Taylor II						
ZFATTIE	Lambda Allopecius VI						
ZFFFFFF	Omicron Pacmanicus VI						
ZFGSFHC	Theta Diggusduggus VII						
ZFLUFFY	Mu Cooper IV						
ZFQLMNY	Beta Allopecius XI						
ZGCYCVM	Rho Milkius XI						
ZGEARSO	Omicron Rutgers IV						
ZGFJHDG	Sigma Thompson V						
ZGFSNCK	Chi Gronulus III						
ZGGGGGG	Epsilon Dominatrix IX						
ZGHAIEH	Psi Goldthwait VI						
ZGORILL	Chi Crunkuli X						
ZGPUTCL	Lambda O'Sullivan IV						
ZGUESSS	Pi Crunkuli IV						
ZHGKJDK	Eta Young IX						
ZHHHHHH	Iota Shannahan XI						
ZIGGLER	Zeta Noriega I						
ZIGZAGS	Belletaco Spitzner VII						
ZIIIIII	Theta Yodeli XI						
ZILICON	Kappa Woodward V						
ZILLION	Bubblicius Disraeli V						
ZIMARIO	Bananaramus Shannahan VII						
ZIMOTHY	Nu Clinton II						
ZINCAAA	Lambda Walker IX						
ZINNIAS	Upsilon McDurkee IV						
ZIPPERS	Theta Pennington XI						
ZIPPITY	Sigma Cattusdoggus V						
ZISASDF	Xi Rudd II						
ZITFACE	Nu Milkius II						
ZITHERS	Equipajus Young XI						
ZIVVVNB	Phi Trixrabbitus II						
ZIWTWNB	Phi Trixrabbitus II						
ZIXTEEN	Lambda Belletaco IX						
ZJAYJAY	Pi Dudebaddus XI						
ZJEILNG	Chi Cheetus XI						
ZJJJJJJ	Tau Mack III						
ZJTHREE	Pi Trixrabbitus IV						
ZKATERS	Alpha Robinson VI						
ZKIRBYZ	Omega Walker VIII						
ZKKKKKK	Lambda Abbrevianus III						
ZKQLMSO	Mu Goldthwait IV						
ZLITHER	Iota Saladus XI						
ZLLLLLL	Beta Lepidopterus V						
ZLLOOPP	Gronulus Tyler III						
ZLOVEYO	Alpha Jones V						
ZLQLMNS	Mu Goldthwait IV						
ZLSVLJL	Gamma Bob VIII						
ZMLPFIM	Delta North V						
ZMMMMMM	Tau Corpulus I						
ZNDROID	Beta Harris VIII						
ZNNNNNN	Theta Cheetus V						
ZNZIBAR	Psi Dudebaddus IX						
ZOCCOLA	Zeta Garcia I						
ZOIDBRG	Eta Harris XI						
ZOLPHIN	Kappa Abbrevianus II						
ZOMBIES	Crematorius Jones IV						
ZOOLAND	Sigma Fustulus III						
ZOOLLPP	Cattusdoggus Hernandez XI						
ZOOLOGY	Psi Tyler VIII						
ZOOMING	Omicron Shafer X						
ZOOOOOM	Omega Meadows VIII						
ZOOOOOO	Fritus O'Kelly V						
ZORKIII	Pi O'Mally VI						
ZORKING	Linoleus Franklin II						
ZOTTFFS	Misogynus Goldthwait VI						
ZOWSERS	Pi Billclintonus IX						
ZOYAGER	Pacmanicus Lewis IX						
ZPESPQA	Diggusduggus Cooper X						
ZPFLMNZ	Iota Allen VIII						
ZPLANET	Delta Franklin VIII						
ZPPPPPP	Zeta Black XI						
ZPQLMNO	Omicron Harrison IV						
ZPWATNU	Bob McCartney V						
ZPZLMNF	Iota Bubblicius XI						
ZPZPAAA	Crematorius Johnson II						
ZQQQQQQ	Gamma Perambulus XI						
ZRAYTRT	Epsilon Cheetus VII						
ZRRRRRR	Rho Misogynus VIII						
ZRSJMNM	Gamma Bob VIII						
ZSANIKU	Phi Blivebarkerus XI						
ZSANITY	Phi Crunkuli X						
ZSCOOBY	Pi McMahon VIII						
ZSGHDFH	Lambda Young XI						
ZSPACEZ	Pi Mousketeerus I						
ZSQLMKO	Gamma Bob VIII						
ZSSDMTW	Omega Trixrabbitus V						
ZSSSSSS	Delta Rutgers IX						
ZSWEETY	Lambda Milkius I						
ZTEENSY	Eta Yodeli X						
ZTPRSTV	Crustulus Waldorf V						
ZTQLMJO	Sigma Davis XI						
ZTTTTTT	Dyxichix Pennington VII						
ZTUDIED	Delta Molotov III						
ZUCKERZ	Eta Stemple XI						
ZUDJKTU	Gronulus Hathaway XI						
ZUICIDE	Upsilon Brooks III						
ZULTANZ	Iota Westinghouse V						
ZUMPAPA							
ZUNAAEA	Pi Dyxichix I						
ZUUUUUU	Beta DuPree XI						
ZVGADVI	Psi Mousketeerus II						
ZVISION	Delta Shatner III						
ZVQFMNO	Gamma Bob VIII						
ZVVVVVV	Gamma Tyler XI						
ZWHIMPY	Kappa Harris I						
ZWINTER	Eta Anderson IX						
ZWWWWWW	Sigma Paulreiserus III						
ZWZDORA	Xi Bellegrandus X						
ZXCVBNM	Nu Spitzner IV						
ZXHSKBE	Omicron Stemple XI						
ZXSGFUZ	Theta Cheetus VI						
ZXTQUVY	Theta Blivebarkerus XI						
ZXXXXXX	Tau Hippidipsus X						
ZYCLOPS	Kappa Harrison I						
ZYGMUNT	Theta Doritus VI						
ZYGOTES	Slobulus Thompson IV						
ZYMOSIS	Waldorfus Easthouse XI						
ZYMURGY	Psi Pannus II						
ZYSKCNO	Upsilon Symington XI						
ZYUGIOH	Tau Taylor XI						
ZYXAAAA	Psi Nelson VI						
ZYXWVUT	Alpha Dunn VIII						
ZYYYYYY	Xi O'Kelly X						
ZYZZYVA	Delta Bubblicius I						
ZZLBFRP	Rho Bubblicius X						
ZZPANKS	Gamma Bob VIII						
ZZQLCNO	Upsilon Symington XI						
ZZSUTLU	Omicron Mills XI						
ZZWDORA	Delta Blivebarkerus VI						
ZZZYZZZ	Sigma Unicornius VI						
ZZZZZAA							
ZZZZZZA	Theta Wallace X						
ZZZZZZB	Cattusdoggus Lewis VI						
ZZZZZZC	Theta O'Mally III						
ZZZZZZD	Psi Cancerus III						
ZZZZZZE	Phi Leprus V						
ZZZZZZF	Beta Young IX						
ZZZZZZG	Xi Humptydumptus X						
ZZZZZZH	Pi Stemple II						
ZZZZZZI	Epsilon Trixrabbitus VI						
ZZZZZZJ	Fustulus Capulet VII						
ZZZZZZK	Theta Allopecius V						
ZZZZZZL	Omicron Robinson X						
ZZZZZZM	Xi Jones VI						
ZZZZZZN	Rho Adams VIII						
ZZZZZZO	Upsilon Cooper III						
ZZZZZZP	Dudebaddus Cooper IX						
ZZZZZZQ	Abbrevianus Waldorf I						
ZZZZZZR	Mu Bubblicius V						
ZZZZZZS	Dominatrix Benedict VI						
ZZZZZZT	Phi Pacmanicus XI						
ZZZZZZU	Mu Cartwright V						
ZZZZZZV	Mu Hippidipsus II						
ZZZZZZW	Polepositioni Nicholson VII						
ZZZZZZX	Tau Hippidipsus XI						
ZZZZZZY	Gamma McCartney X						
ZZZZZZZ	Omicron Bob X						
